inq: ehb
fop: jyt gvn baa ieg
jbt: cgh
xrj: tui vwj
ack: yts igd gsb rsf
rka: tup
syn: qbb tof yrb rmn
dwf: zjw ntr rka
xip: out
spj: jsq njb clh gxd
xaa: ntm
hsw: jih icw jjy fop
vbn: yrb emk tof qbb
gzk: rze siu
ibf: aqc
nzt: rhl fng lth
ygy: hau ont
flu: ban
vkr: shf dkz jdr
itj: out
ymh: xlz gwr njr
eyi: gue puu mxo jbf prd sbv knf gzk umd hkj mqh
ikm: out
dbn: spj
qkl: nzx lva
ukj: ehb kox
snq: ukj
dih: qur hka
mxo: uch zld
uyw: lbp aik yln
ahh: wid hbk qom
jai: kox
jdt: ocv
zzz: lcb
sfd: sxr
jvm: brn
pjs: qxk yve
ytk: zli smq
ojo: bxl iwe lsn
puu: mvq mvi krf
cvi: ddp xol
meq: ias
hjz: ldi wom cvi
rmn: wal hbl jje
gmt: vcs jrp xlr
mju: tno jgp
cli: hvo qvq mvk
fmj: puu gue hmi jbf prd sbv too ppl gzk hkj umd xkj
jlt: ltc pvu gxx fbh ajs
duh: iiy
xax: yoh eeb
bnj: mje quh xsc
msp: amn htp dtr
jfb: oas tui
xud: wom cvi vvi ldi
tof: umb wal
xuq: cgh
smq: pwk
ias: jai smq
ent: jbt
zqt: wug snq
uvj: yqg rgp unc bxk fbv rvn jdt mju
nsi: dtr amn
tnj: jau
ooi: pvu gxx ajs
yln: out
jzp: dwf rud bwr
amn: rhr spf
cpz: run
xuw: kcb
bxl: vna
tui: nrb xfq pjh amr egc obh gem mfo ztv mcu lel ttg egg ibn
pjv: jsq clh
dbq: jyj qur
hfh: you heu
uyn: gxe
qgf: ehb
jnm: pwk ehb uvj
zjw: tup qlh
fgm: zqt lgl eha
coa: gnu ugv
ufc: fdn
eto: vgn ggq rdt srg
rhl: ymw qkl jha
jvb: mrd
iiy: tri dzn xiy xaa
ayv: iza
mvi: sfk hsw
gsb: tup qlh iza
bxk: khm tno ocv
mnw: wvp cpz
bpy: ikm
fft: ewz fsq jvo
gst: vkr
egc: ixe
yqr: oas
rxi: you cgh heu
bbb: hvo
igd: tup qlh iza
qdd: iwt
whi: syn biz vbn
ddp: uyr rmf pfr ppj
xuh: obt tqh
ehz: dct
pyo: toc hee
szn: bfw pss
xyy: pjs
paq: out
gxx: dmd
sfk: jih icw jjy
jju: ipw ijp wwj kny
zdd: xud hjz aql
nns: ipw kny
wal: out
hcs: ier cuq
azi: fmj ugv mha eyi
xcw: qlh tup
csh: dnm bpy
vna: tup qlh iza
liy: mha eyi fmj ugv
hxt: aik han
mfo: apz msp nsi
bon: mce jnm ldr ukj
twy: out
msb: zsb maf pyo
lan: hpp
qel: eeb yoh fdn rhh
biz: qbb
njb: klt flu kcw
bdk: aqc
sza: hka
fts: omg
spf: swc ohw onx qvv
rnp: out
uch: uxu
kpa: vwj tui oas
klz: iza tup qlh
hhm: klz
yrb: fxd wal umb
zpx: kzx bkl
nrb: nsi
kat: ijp kny wwj ipw
lgn: kox pwk ehb
pgh: bkl
bma: msb vfw xpb
mpq: heu you
ixe: sfd jpa ecl
jsq: flu klt
obm: cpz xyy wvp
qlh: atz euz jay ply dbn fqb xow utx cli zdd csd yho gck ncv bbb pbn
clh: kcw klt uvc
okj: qel xax awh
qom: out
sbx: bwg nro
bqb: pwk kox uvj
prd: rze siu
run: lil yve
iei: bxl wpl
xvn: ewz fsq
xqp: ayv eli
tqh: eli dio
jyj: jcz
xnp: acl
nro: lgg eto
iza: fqb dbn jay euz atz ybv ppi zdd utx xow kub ncv gck yho
ier: hau
lcb: liy nng
uph: bfw pss
hbk: out
lbp: out
sje: ycm qvv
isl: fbh pvu ltc
wid: out
ydd: muj kcb tnj
jjy: ieg
muj: kzj ytk
toc: mng
ehp: ecl
amr: qlj vhf okj dfw
jyt: heu you
omg: mrd vml
han: out
qxk: vwj tui
kel: uvj kox ehb pwk
qbv: jyj qur hka
pnz: ekp jjr
rdt: zyp
hvo: bto phm vug ond
mqh: mvi dti
gut: bwg nro joi
hmh: ooi clb axc clv hbn hpn ypl vdt hcs ifv sal eno mzq onh jlt pax dkm zgy arr
frh: heu you
xfp: gsb
jbf: pou
wer: fsq
pwk: zef fts mju krc hca rgp fbv bxk jdt zet
qji: bce azi nng liy
pax: zqt
xpb: pyo maf zsb
eeb: ugv fmj gnu mha eyi
wpl: pfh lxw vna
doy: etu nyl frh
dzf: eyi mha fmj gnu
czu: fbh pvu
unp: ucv jdx mvz mrk
bwg: eto rby lgg
wvz: kny
dnj: oas
maf: ejb hee
pka: out
jdx: itj
tno: xfp vdo ack rry
ipw: psl bpy iqj
psl: ioy
xsf: oas vwj
ban: oas
ecl: iww lud
too: gmt smx
rgl: bon
vvi: ddp
etu: you
lil: oas vwj
dbe: emk rmn yrb
pjh: okj qlj lux
kub: hjz aql
oyp: iwc kel ldt
ucv: dwq paq
uzb: mdr
jcz: bpi ucv
hmi: gmt
osd: dtr amn htp
gem: gwr njr
egg: pnz opr
ioy: out
cgh: met zgp fet wwq lan lvk xed duh pgh zpx oos kdz ehz ydb xyj ohv
sxr: dzf sxg
mng: unw aik lbp
vml: obt tqh xqp
zql: icw fop
fbv: ojo
gxe: wid
lgg: vgn uzb srg
bqa: heu
lis: mje toq xvd
krc: gdi xpl qzw
fqb: guw cpz xyy
ttg: eky trl
sil: doy
afs: iwe wpl wwg
gck: pjv nat xqh spj
bkl: nns kat
bcm: oas
ryg: inq iwc kel
kcb: kzj jau
ksa: wwg wpl lsn
xol: ppj bcm rmf uyr
pfh: tup
kug: uyw hxt
sbv: pss nzc
aqc: etu nyl hfh xuq frh
dct: lgc xos
ond: ibb yqr jee zxg
ybv: bnj rrh
cwj: mra
lel: rto ehp omk
mvq: xnp hsw
nyh: uhu run
aik: out
swc: gnu fmj
cuq: ont fll
xiy: ntm uyn
klt: xrj stl jfb
ymw: nzx
yho: pjv xqh nat
vcs: you
ldt: ehb kox
cqu: eyi gnu
xyj: gut
fse: qlh iza
arr: yre dex ygy
oop: xpb hww vfw
voc: you cgh
zmr: hbk rvc
tob: kzx bkl
wwg: lxw
jqy: dtr htp
ibb: tui
nyl: heu
fsq: tup qlh
utx: aql
umb: out
guw: pjs run
rvc: out
awh: rhh yoh
lux: ufc awh qel
iwt: ias jau kzj
own: wwj csh ipw
ont: sgh fup
sgh: uvj ehb
jem: bce
uvc: jfb xrj
wwq: vfw xpb
xlz: rsw zmi ula zzz
rud: ntr wnh fse zjw
zgp: sza qbv brn dbq
pfr: tui
brn: qur
msi: doy aqc
hka: zui unp
ifv: oyp ybs lge
jpa: lud iww uat
dti: fui zql hsw
vwj: amr ibn lel gem cve isk ymh pjh ncs egc
bpi: paq itj dwq
xfq: asc
zui: jdx
zet: iei hzh afs ksa
ldr: pwk ehb kox
htc: mrd xuh vml
ifo: pvr
fxd: out
umd: mvq
xvd: cec
ohv: qbv sza dih brn
tup: yho gck mnw ncv kub obm bbb pbn euz atz jay dbn ply fqb xow cli zdd ybv ppi csd
toq: zzi xsf cec jyo
dio: iza qlh
akc: pwk ehb uvj kox
yts: tup
wum: ugv eyi
baa: cgh heu
ejb: uyw
fet: sii dct ifo
ugv: jbf sbv qyx uph prd knf xkj ppl szn hmi gzk
qur: zui
ekx: zgy arr mzq eno sal ifv nzt tmi vdt axc clv isl fgm
dfw: xax awh
knf: mvi
alo: meq iwt
vhf: awh ufc xax qel
uml: heu
puy: msi ibf
ekb: muj kcb
eon: ehb uvj
mdk: out
uxu: cgh heu
ocv: ack xfp
xow: xud
joi: lgg zsc eto
mdr: out
yve: tui
oos: xqe kzx
wom: ddp
ibn: jqy nsi
quh: zzi xsf jyo dnj
qbb: wal fxd hbl
ula: yww qji
nzc: xyl ent ulr
hca: khm ocv
lth: ymw
mjq: qvv swc ohw ycm
xos: dbe
jje: out
nzx: pwk ehb kox
hom: sxg coa
ldi: ddp xol
zld: ihn rxi
unw: out
khm: arq
ncs: ixe rto omk ehp
rhr: qvv onx ycm ohw
pss: ulr ent xyl jke
mrd: tqh obt
wnh: qlh
sal: xuw
dex: ulm hau
jgp: rry xfp vdo arq
qle: uvj pwk
rze: dac sil
yqg: xvn fft wer
vgn: mdr rnp pka zyp
eno: ryg
dac: aqc ktg
vhe: ahh
qvq: vug rlj ond
vdo: yts
unc: xpl
fwk: nzx lgn
zsb: kug ejb hee
ply: pjv xqh
ybs: ldt
gvn: you
rov: yas xol
hau: fup qle sgh
bto: jee kpa ibb zxg
lgc: biz syn vbn
rry: gsb igd rsf
hbn: yre dex ier ygy
uhu: lil
fwz: rxi uxu ihn
fbh: eon akc dmd
gnu: prd uph sbv qyx jbf too szn ppl knf gue hmi puu mxo hkj xkj mqh gzk
bfw: xyl jke
hbl: out
rgp: htc
vug: jee kpa ibb
dtr: sje mjq
ulm: fup
lgl: bon snq wug
ppi: hvo qvq
obh: ehp omk
siu: dac bdk
met: msb hww xpb
rlj: ibb yqr kpa jee
opr: jjr
hyw: hom
wwj: psl
apz: amn htp
ycm: fmj ugv mha
ppl: mvq dti mvi krf
jih: baa ieg gvn
ccf: zmr gxe ahh
cec: oas
mcu: nkw trl opr pnz eky
bce: gnu
bmi: xip wid qom
jyo: vwj oas tui
ulr: tdh bqa
kdz: sbx tqw gut
jke: mpq tdh voc
gue: gmt smx
isk: osd
pvu: akc eon
ewz: qlh tup
xyl: bqa mpq jbt tdh
gdi: jdr
nkw: jjr ekp
xed: xqe
zyb: gxe ahh bmi
qwm: isl hbn czu clb axc vdt ypl hpn ooi dkm arr sal hcs eno
hkj: rze siu puy
kox: fbv ysm unc yqg zet rvn dnr mju gst
wvp: uhu
lap: tri xaa dzn xiy
xqh: gxd tom njb
uyr: oas
icw: ieg gvn jyt
njr: zmi rsw ula
ktg: frh xuq hfh nyl
zzi: oas
uat: dzf
fng: fwk jha
mvz: paq
lvk: sbx tqw
hpn: lge ybs oyp
krf: hsw fui zql xnp
qyx: aqw fwz
rrh: mje toq xsc
ggq: mdr zyp mdk
xhj: mha ugv fmj
jay: lis rrh
iwe: lxw vna xcw
mce: uvj
ztv: vhf lux qlj okj
lud: dzf sxg
dnm: ioy ikm
jjr: bmu cqu xhj
obt: ayv eli
rto: hyw jpa ecl
iww: sxg coa
bmu: gnu ugv mha
tmi: qdd
kzj: zli qgf jai bqb
mvk: vug rlj phm bto
jee: vwj tui
fll: sgh
eli: iza tup
dzn: vhe uyn ntm ccf
pvr: vbn syn
jau: smq bqb
stl: vwj
onh: lth
zli: uvj kox ehb
clv: rhl
yaz: toc kug hee
kzx: own wvz
ieg: heu you
ncv: bnj rrh lis
yww: liy wum
rnl: jvo ewz
gwt: lap iiy
tqw: bwg joi
mra: nro
aqw: uxu
sii: lgc whi pvr
euz: nyh
ntm: bmi
mrk: dwq paq
oas: egc ncs obh ymh jcc gem mcu ztv ttg lel ibn egg nrb xfq pjh isk cve amr
lmy: ksa hzh afs iei
gry: sii
mzq: ydd alo ekb
eha: wug snq
gwr: zmi
dnr: jgp khm tno
kny: psl dnm iqj
yoh: fmj gnu mha
dkm: ajs gxx ltc
pou: jrp
heu: jvm ohv bma tob ydb xyj ehz hiw gry oop duh pgh xed cwj kdz oos zpx fet zgp lan lvk wwq
bwr: fse rka ntr wnh zjw
ppj: tui oas vwj
dwq: out
hww: zsb yaz
dmd: uvj kox pwk
iqj: twy
rmf: tui vwj
omk: sfd jpa ecl
zmi: jem
rsf: qlh tup
ohw: eyi fmj
ntr: tup iza
jha: lgn nzx
fui: jjy
rsw: qji lcb yww
sxg: fmj gnu eyi
eiq: ikm ioy
ijp: psl eiq iqj bpy
hzh: lsn wpl
jdr: rud dwf
xkj: fwz zld
wug: mce ukj ldr nok
ysm: vkr xpl gdi
atz: aql
ajs: eon akc
nat: jsq njb gxd clh
mha: mqh knf too szn sbv uph mxo hmi
cve: apz
clb: ybs
hee: hxt mng uyw
kcw: stl
zgy: zqt lgl
qzw: jzp dkz shf
nok: uvj kox ehb pwk
smx: uml xlr
phm: kpa jee zxg
axc: rgl
you: tob bma kdz xyj lan gwt ehz gry hiw
emk: fxd
asc: sfd
fup: kox
hiw: gut mra tqw
arq: yts igd gsb
lva: pwk kox uvj
ekp: bmu xhj
trl: fbp ekp jjr
onx: gnu mha
csd: nyh wvp xyy cpz
tri: vhe zyb
zef: fft xvn rnl hhm
xpl: jdr shf
xsc: dnj jyo cec
lxw: tup iza
rvn: fft wer hhm rnl
ehb: bxk hca lmy zet dnr gst rgp rvn zef mju fvj
zyp: out
xlr: heu
lsn: xcw
tdh: heu cgh
qlj: xax ufc awh
fvj: jvb omg htc
qvv: mha eyi gnu fmj
aql: rov vvi
mje: cec jyo
ltc: dmd akc
ypl: qdd ydd
jcc: njr xlz
nng: gnu ugv eyi mha
htp: rhr sje mjq
tom: klt uvc
zsc: srg uzb
svr: qwm hmh ekx
yre: fll ont hau
vdt: xuw alo qdd ekb ydd
rby: rdt vgn
ihn: cgh you
dkz: rud bwr
iwc: uvj ehb pwk
zxg: oas tui vwj
pbn: lis rrh
lge: ldt inq kel
yas: ppj bcm rmf pfr uyr
jvo: qlh
acl: baa
srg: mdr mdk rnp zyp pka
fbp: bmu cqu
hpp: xaa xiy dzn
jrp: heu cgh you
rhh: fmj
fdn: mha ugv fmj gnu
gxd: kcw flu klt
shf: bwr rud dwf
xqe: wvz own jju kat
ydb: sza dih dbq brn
vfw: yaz maf pyo
eky: ekp jjr